Aaaron	Aaron
Aabraham	Abraham
Aadam	Adam
Aagnes	Agnes
Aahleigh	Ashleigh
Aahley	Ashley
Aainsworth	Ainsworth
Aalbert	Albert
Aalexander	Alexander
Aalfred	Alfred
Aalice	Alice
Aamanda	Amanda
Aambrose	Ambrose
Aamy	Amy
Aan	Ann
Aanastatia	Anastatia
Aanderson	Anderson
Aandrea	Andrea
Aandrew	Andrew
Aandrzej	Andrzej
Aangela	Angela
Aann	Ann
Aannah	Annah
Aanne	Anne
Aannette	Annette
Aannie	Annie
Aanthony	Anthony
Aanton	Anton
Aantony	Antony
Aarabella	Arabella
Aargaret	Margaret
Aarmstead	Armstead
Aarmstrong	Armstrong
Aarnold	Arnold
Aarthur	Arthur
Aathony	Anthony
Abert	Albert
Achibald	Archibald
Adele'	Adele
Adndrew	Andrew
Adniel	Daniel
Afred	Alfred
Agns	Agnes
Agustus	Augustus
Aice	Alice
Alcie	Alice
Aleander	Alexander
Alex'r	Alexander
Alexanderg	Alexander
Alexanderj	Alexander
Alfrd	Alfred
Aliastair	Alistair
Aliaster	Alister
Amnie	Annie
Amrgaret	Margaret
Anastatia	Anastasia
Andre'	Andre
Andree	Andrew
Andreea	Andrea
Anexandra	Alexandra
Anngela	Angela
Annna	Anna
Annne	Anne
Annne	Anne
Annnice	Annice
Annnie	Annie
Annny	Anny
Anold	Arnold
Anthiny	Anthony
Anthoney	Anthony
Archiblad	Archibald
Arhtur	Arthur
Arhur	Arthur
Arthue	Arthur
Aseneth	Asenath
Ashleyr	Ashley
Athur	Arthur
Aurther	Arthur
Aurthur	Arthur
Avvverella	Averella
Baeatrice	Beatrice
Banjamin	Benjamin
Barabara	Barbara
Bartholamew	Bartholomew
Batrice	Beatrice
Bbarker	Barker
Bbeau	Beau
Bbegum	Begum
Bbenton	Benton
Bbernard	Bernard
Bbernetta	Bernetta
Bbertenshaw	Bertenshaw
Bbickernough	Bickernough
Bblanche	Blanche
Bbond	Bond
Bbradshaw	Bradshaw
Bbradshawe	Bradshawe
Bbrammer	Brammer
Bbrian	Brian
Bbrown	Brown
Bbrownsword	Brownsword
Bbruce	Bruce
Bbryan	Bryan
Beartrice	Beatrice
Beatric	Beatrice
Benajamin	Benjamin
Benajmin	Benjamin
Benediict	Benedict
Benjain	Benjamin
Benjamen	Benjamin
Benjaminn	Benjamin
Benjamln	Benjamin
Benjamon	Benjamin
Benjanin	Benjamin
Benjemin	Benjamin
Benjiamin	Benjamin
Benjimin	Benjamin
Benneth	Kenneth
Benyamin	Benjamin
Beratrice	Beatrice
Bertramc	Bertram
Betram	Bertram
Betrice	Beatrice
Birgitte	Brigitte
Bnanjamin	Benjamin
Bnejamnin	Benjamin
Boadecia	Boadicea
Brdget	Bridget
Bridgeta	Bridget
Brittannia	Britannia
Byrom	Byron
Cadwaleder	Cadwalader
Caeser	Caesar
Cahrles	Charles
Cahterine	Catherine
Carherine	Catherine
Carline	Caroline
Carolin	Caroline
Carroline	Caroline
Cartgerine	Catherine
Cartherine	Catherine
Catheirne	Catherine
Cathereine	Catherine
Cathernie	Catherine
Cathorine	Catherine
Ccampbell	Campbell
Ccantle	Cantle
Ccardoc	Cardoc
Ccarles	Charles
Ccarlton	Carlton
Ccarole	Carole
Ccaroline	Caroline
Ccartledge	Cartledge
Ccatherine	Catherine
Ccatrin	Catrin
Ccecilia	Cecilia
Cchadwick	Chadwick
Cchancellor	Chancellor
Ccharles	Charles
Ccharlotte	Charlotte
Ccherie	Cherie
Cchristabel	Christabel
Cchristian	Christian
Cchristine	Christine
Cchristopher	Christopher
Cclare	Clare
Cclegg	Clegg
Cclement	Clement
Ccolclough	Colclough
Ccolomba	Colomba
Cconstance	Constance
Cconstance	Constance
Ccornelius	Cornelius
Ccostigan	Costigan
Ccottam	Cottam
Ccotton	Cotton
Ccourcy	Courcy
Ccourtney	Courtney
Ccraig	Craig
Ccristopher	Christopher
Ccrompton	Crompton
Ccuikshank	Cruikshank
Ccutts	Cutts
Ccyril	Cyril
Cecila	Cecilia
Ceclia	Cecilia
Chalres	Charles
Charlette	Charlotte
Charllote	Charlotte
Charloatte	Charlotte
Charlotee	Charlotte
Charlottee	Charlotte
Charolotte	Charlotte
Chistopher	Christopher
Chorlotte	Charlotte
Chris'r	Christopher
Chrisatiana	Christiana
Chrisopher	Christopher
Christhoper	Christopher
Christoher	Christopher
Christoper	Christopher
Christopherp	Christopher
Christpher	Christopher
Chritine	Christine
Chritopher	Christopher
Chrles	Charles
Chrsitine	Christine
Chruchill	Churchill
Cilfford	Clifford
Clauda	Claudia
Cliford	Clifford
Conelia	Cornelia
Conraed	Conrad
Conrnelius	Cornelius
Constamnce	Constance
Constancce	Constance
Corneluis	Cornelius
Costance	Constance
Ctherine	Catherine
Cuthberth	Cuthbert
Daisny	Daisy
Daneil	Daniel
Davdi	David
Davidd	David
Davidf	David
Davidj	David
Davidp	David
Davidr	David
Davjd	David
Davuid	David
Dawm	Dawn
Dawna	Dawn
Dawnl	Dawn
Dawnm	Dawn
Dawnn	Dawn
Ddavid	David
Ddavidson	Davidson
Ddawn	Dawn
Ddawood	Dawood
Ddean	Dean
Ddeanna	Deanna
Ddeborah	Deborah
Ddenis	Denis
Ddennis	Dennis
Ddora	Dora
Ddoris	Doris
Ddorothy	Dorothy
Ddouglas	Douglas
Ddouglas	Douglas
Deanb	Dean
Deanm	Dean
Deboeah	Deborah
Deborab	Deborah
Deboragh	Deborah
Debotah	Deborah
Derborah	Deborah
Dionysuis	Dionysius
Dioysius	Dionysius
Doeothy	Dorothy
Donaald	Donald
Dorathy	Dorothy
Dorolthy	Dorothy
Dororthy	Dorothy
Dorothry	Dorothy
Dorotht	Dorothy
Dorothya	Dorothy
Dorothym	Dorothy
Dorothyr	Dorothy
Dorotny	Dorothy
Dorotthy	Dorothy
Dorotyh	Dorothy
Doroyhy	Dorothy
Dorpothy	Dorothy
Dorthoy	Dorothy
Dorthy	Dorothy
Dortohy	Dorothy
Dougla	Douglas
Dougles	Douglas
Doulgas	Douglas
Doulglas	Douglas
Dsvid	David
Dvid	David
Easther	Esther
Edaward	Edward
Edawrd	Edward
Edmd	Edmund
Edmomd	Edmond
Edw'd	Edward
Edwarda	Edward
Edwardc	Edward
Edwardh	Edward
Edwardj	Edward
Edwardt	Edward
Edwarrd	Edward
Edwd	Edward
Edwrad	Edward
Edwrd	Edward
Eearl	Earl
Eearle	Earle
Eeastman	Eastman
Eeastwood	Eastwood
Eebenezer	Ebenezer
Eedith	Edith
Eedmund	Edmund
Eedwaed	Edward
Eedward	Edward
Eedward	Edward
Eedwin	Edwin
Eeileen	Eileen
Eeleanor	Eleanor
Eeliza	Eliza
Eelizabeth	Elizabeth
Eelizabeth	Elizabeth
Eellen	Ellen
Eemil	Emil
Eemily	Emily
Eemma	Emma
Eeorge	George
Eephraim	Ephraim
Eernest	Ernest
Eernesto	Ernesto
Eestella	Estella
Eesthella	Esthella
Eesther	Esther
Eesther	Esther
Eethel	Ethel
Eeugene	Eugene
Eeveline	Eveline
Eevelyn	Evelyn
Efffie	Effie
Efward	Edward
Ehtel	Ethel
Eilliam	William
Eilzabeth	Elizabeth
Eizabeth	Elizabeth
Eliabeth	Elizabeth
Eliozabeth	Elizabeth
Eliszabeth	Elizabeth
Elixabeth	Elizabeth
Elixzabeth	Elizabeth
Eliz'th	Elizabeth
Elizaa	Eliza
Elizabeeth	Elizabeth
Elizabeh	Elizabeth
Elizabetgh	Elizabeth
Elizabethh	Elizabeth
Elizabetj	Elizabeth
Elizabett	Elizabeth
Elizabetth	Elizabeth
Elizabety	Elizabeth
Elizabetyh	Elizabeth
Elizabeyh	Elizabeth
Elizabrh	Elizabeth
Elizabrth	Elizabeth
Elizabteh	Elizabeth
Elizabth	Elizabeth
Elizabveth	Elizabeth
Elizaebth	Elizabeth
Elizaeth	Elizabeth
Elizaneth	Elizabeth
Elizaqbeth	Elizabeth
Elizasbeth	Elizabeth
Elizaveth	Elizabeth
Elizazabeth	Elizabeth
Elizazbeth	Elizabeth
Elizbabeth	Elizabeth
Elizbaeth	Elizabeth
Elizebeth	Elizabeth
Elizebth	Elizabeth
Eliziabeth	Elizabeth
Elizqabeth	Elizabeth
Elizr	Eliza
Elizsabeth	Elizabeth
Elizth	Elizabeth
Elizthabeth	Elizabeth
Elizzbeth	Elizabeth
Elkizabeth	Elizabeth
Ellizabeth	Elizabeth
Ellla	Ella
Elllen	Ellen
Elllinor	Ellinor
Elzabeth	Elizabeth
Elziabeth	Elizabeth
Em'ly	Emily
Emiliy	Emily
Emilu	Emily
Emily)	Emily
Emilye	Emily
Emilyh	Emily
Emilyv	Emily
Emlia	Emilia
Emlie	Emilie
Emliy	Emily
Emly	Emily
Emmly	Emily
Emmma	Emma
Emmmanuel	Emmanuel
Emmmeline	Emmeline
Esssther	Esther
Ferderick	Frederick
Ffederick	Federick
Ffelicity	Felicity
Fflorence	Florence
Ffloyd	Floyd
Ffrances	Frances
Ffrancis	Francis
Ffrank	Frank
Ffred	Fred
Ffreda	Freda
Ffrederick	Frederick
Fjorence	Florence
Floremce	Florence
Floremnce	Florence
Florenace	Florence
Florencc	Florence
Florenceb	Florence
Fmily	Emily
Fred'k	Frederick
Fredk	Frederick
Frrederick	Frederick
Geerald	Gerald
Geirge	George
Geo	George
Georrfrey	Geoffrey
Gerarld	Gerald
Gerffrey	Geoffrey
Gergory	Gregory
Gergtrude	Gertrude
Geroge	George
Ggail	Gail
Ggeorge	George
Ggeorgina	Georgina
Ggerald	Gerald
Ggilbert	Gilbert
Ggladys	Gladys
Ggordon	Gordon
Ggorge	George
Ggrace	Grace
Ggraham	Graham
Ggreenhough	Greenhough
Ggregory	Gregory
Ggregson	Gregson
Ggrham	Graham
Goerge	George
Gordfrey	Godfrey
Gordpn	Gordon
Gordpn	Gordon
Gorege	George
Gorge	George
Haaarriet	Harriet
Hharles	Charles
Hharold	Harold
Hharriet	Harriet
Hharriot	Harriot
Hharrison	Harrison
Hharry	Harry
Hharvey	Harvey
Hhawksley	Hawksley
Hheath	Heath
Hhelen	Helen
Hhelene	Helene
Hhenderson	Henderson
Hhenry	Henry
Hherb	Herb
Hherbert	Herbert
Hhindle	Hindle
Hhobson	Hobson
Hholt	Holt
Hhope	Hope
Hhoward	Howard
Hhudson	Hudson
Hhughes	Hughes
Hhumphry	Humphry
Hhunter	Hunter
Hhurst	Hurst
Hhutchinson	Hutchinson
Hjohn	John
Hnnnah	Hannah
Iingrid	Ingrid
Iinkerman	Inkerman
Iiona	Iona
Iirene	Irene
Iirvin	Irvin
Iirving	Irving
Iisaac	Isaac
Iisabel	Isabel
Iisabella	Isabella
Iisobel	Isobel
Iornmonger	Ironmonger
Jdhn	John
Jjames	James
Jjane	Jane
Jjean	Jean
Jjeanne	Jeanne
Jjeffrey	Jeffrey
Jjevon	Jevon
Jjitendra	Jitendra
Jjoanne	Joanne
Jjohn	John
Jjohnn	John
Jjohnson	Johnson
Jjon	Jon
Jjonathan	Jonathan
Jjoseph	Joseph
Jjoyce	Joyce
Jusstine	Justine
Keeeley	Keeley
Kkathleen	Kathleen
Kkelvin	Kelvin
Kkevan	Kevan
Kkimberley	Kimberley
Kkingsley	Kingsley
Kkirkland	Kirkland
Kknowles	Knowles
Leoanrd	Leonard
Leoanrd	Leonard
Llaird	Laird
Llancaster	Lancaster
Llancelot	Lancelot
Llangford	Langford
Llangtry	Langtry
Llaura	Laura
Llauren	Lauren
Llawrence	Lawrence
Llayah	Layah
Llaycie	Laycie
Lleana	Leana
Llee	Lee
Lleicester	Leicester
Lleigh	Leigh
Llen	Len
Lleo	Leo
Lleon	Leon
Lleona	Leonara
Lleonard	Leonard
Lleoni	Leoni
Lleonora	Leonara
Lles	Les
Llesley	Lesley
Lleslie	Leslie
Lliam	Liam
Llilan	Lilian
Llilian	Lilian
Llillian	Lillian
Llilly	Lilly
Llily	Lily
Llinda	Linda
Llinden	Linden
Llindley	Lindley
Llindon	Lindon
Llindsey	Lindsey
Llinley	Linley
Llinos	Linos
Llinus	Linus
Llionel	Lionel
Llisa	Lisa
Llittleton	Littleton
Lliy	Lily
Llizzie	Lizzie
Llizzy	Lizzy
Llloyd	Lloyd
Llorna	Lorna
Llouisa	Louisa
Llouise	Louise
Llouyd	Lloyd
Llucas	Lucas
Llvingstone	Livingstone
Maaary	Mary
Maqrtin	Martin
Maragaret	Margaret
Maragret	Margaret
Mararet	Margaret
Marg't	Margaret
Margaarett	Margaret
Margaet	Margaret
Margaget	Margaret
Margagret	Margaret
Margarert	Margaret
Margarewt	Margaret
Margarget	Margaret
Margart	Margaret
Margarte	Margaret
Margartet	Margaret
Margasret	Margaret
Margatret	Margaret
Margeart	Margaret
Margeret	Margaret
Margfaret	Margaret
Margraret	Margaret
Margt	Margaret
Marhorie	Marjorie
Marjoire	Marjorie
Mchael	Michael
Millicnet	Millicent
Mivchael	Michael
Mkichael	Michael
Mlchael	Michael
Mmahmood	Mahmood
Mmanda	Amanda
Mmargaret	Margaret
Mmaria	Maria
Mmaria	Maria
Mmarie	Marie
Mmartin	Martin
Mmartin	Martin
Mmary	Mary
Mmaxwell	Maxwell
Mmay	May
Mmay	May
Mmccormack	Mccormack
Mmckenzie	Mckenzie
Mmclauchlan	Mclauchlan
Mmclean	Mclean
Mmcmahon	Mcmahon
Mmcnaught	Mcnaught
Mmichael	Michael
Mmildred	Mildred
Mmildred	Mildred
Mmmary	Mary
Mmmary	Mary
Mmonique	Monique
Mmonique	Monique
Mmunro	Munro
Mnaggie	Maggie
Mnancy	Nancy
Mnarilyn	Marilyn
Mnatasha	Natasha
Mnathan	Nathan
Mnichael	Michael
Mrgaret	Margaret
Mry	Mary
Natham	Nathan
Nnacy	Nancy
Nncy	Nancy
Nnelizabeth	Elizabeth
Nnessie	Nessie
Nneville	Neville
Nnicholas	Nicholas
Nnpenelope	Penelope
Nnthony	Anthony
Ooctavia	Octavia
Ooldfield	Oldfield
Ooldham	Oldham
Ooliver	Oliver
Ooswald	Oswald
Oowen	Owen
Particia	Patricia
Patirck	Patrick
Patirica	Patricia
Patiricia	Patricia
Patk	Patrick
Patrck	Patrick
Patrifck	Patrick
Patriia	Patricia
Patriicia	Patricia
Patritia	Patricia
Patticia	Patricia
Paukl	Paul
Penelpoe	Penelope
Pentelope	Penelope
Pharoah	Pharaoh
Pheobe	Phoebe
Phiip	Philip
Phililp	Phillip
Phjlip	Philip
Phobe	Phoebe
Phoepe	Phoebe
Phoerbe	Phoebe
Pillip	Phillip
Pparkinson	Parkinson
Ppatricia	Patricia
Ppaul	Paul
Ppearson	Pearson
Ppercy	Percy
Pperveen	Perveen
Pphilip	Phillip
Pphillip	Phillip
Pphyllis	Phyllis
Ppointon	Pointon
Ppowell	Powell
Pprocter	Procter
Ppyllis	Phyllis
Prcy	Percy
Primose	Primrose
Prudnece	Prudence
Ptrick	Patrick
Pual	Paul
Queeenie	Queenie
Ricahrd	Richard
Rich'd	Richard
Richd	Richard
Richd	Richard
Roberet	Robert
Robrt	Robert
Robt	Robert
Roebrt	Robert
Ropbert	Robert
Rrafia	Rafia
Rralph	Ralph
Rrandolph	Randolph
Rrbecca	Rebecca
Rrebekah	Rebekah
Rreginald	Reginald
Rreynolds	Reynolds
Rrginald	Reginald
Rrhoda	Rhoda
Rrichard	Richard
Rrichmond	Richmond
Rrickett	Rickett
Rriding	Riding
Rrigby	Rigby
Rriscilla	Priscilla
Rrobert	Robert
Rroberts	Roberts
Rrobinson	Robinson
Rronald	Ronald
Rrose	Rose
Rrosemary	Rosemary
Rroy	Roy
Rrushton	Rushton
Rrussell	Russell
Rruth	Ruth
Rryan	Ryan
Ruport	Rupert
Ruthh	Ruth
Saaaamuel	Samuel
Saarah	Sarah
Sam'l	Samuel
Saml	Samuel
Sanantha	Samantha
Sarahg	Sarah
Sarahi	Sarah
Sarahj	Sarah
Scotyt	Scotty
Sdamuel	Samuel
Sdavid	David
Sdyney	Syndey
Sephen	Stephen
Sepncer	Spencer
Srah	Sarah
Srah	Sarah
Ssamuel	Samuel
Ssan	Susan
Ssara	Sarah
Ssarah	Sarah
Ssarah	Sarah
Ssatad	Satad
Sscholes	Scholes
Sscliffer	Scliffer
Sscofield	Scofield
Sscott	Scott
Sscott	Scott
Sseed	Seed
Ssefton	Sefton
Ssefton	Sefton
Ssfton	Sefton
Sshaheen	Shaheen
Sshahzad	Shahzad
Ssharron	Sharron
Sshaw	Shaw
Sshepherd	Shepherd
Sshepherd	Shepherd
Sshofield	Shofield
Ssholes	Sholes
Ssidney	Sidney
Ssidney	Sidney
Ssimpson	Simpson
Ssimpson	Simpson
Sslly	Sally
Ssmith	Smith
Ssmith	Smith
Ssmuel	Samuel
Ssndra	Sandra
Sspencer	Spencer
Sspetimus	Septimus
Ssptimus	Septimus
Ssptimus	Septimus
Sstacey	Stacey
Sstainthorpe	Stainthorpe
Sstanley	Stanley
Ssteane	Steane
Sstephen	Stephen
Ssteven	Steven
Sstewart	Stewart
Sstuart	Stuart
Sstudley	Studley
Ssuan	Susan
Ssuan	Susan
Ssusan	Susan
Ssusanne	Susanne
Ssuzanne	Suzanne
Ssydney	Sydney
Ssylvester	Sylvester
Staanley	Stanley
Stanaley	Stanley
Staurt	Stuart
Stepgen	Stephen
Stephanif	Stephanie
Stepheni	Stephen
Stephenj	Stephen
Stephenm	Stephen
Stepheno	Stephen
Stephent	Stephen
Stephern	Stephen
Steplhen	Stephen
Stepnanie	Stephanie
Stepphen	Stephen
Steptimus	Septimus
Steuart	Stuart
Stevphen	Stephen
Strephanie	Stephanie
Sturat	Stuart
Suasan	Susan
Suasnna	Susanna
Susn	Susan
Sussanah	Susannah
Sydeny	Sydney
Sztephen	Stephen
Tabithia	Tabitha
Temprance	Temperance
Terenece	Terence
Tfrank	Frank
Tgomas	Thomas
Thcmas	Thomas
Thersa	Theresa
Thgomas	Thomas
Thnomas	Thomas
Thoams	Thomas
Thoamsine	Thomasine
Thoedore	Theodore
Thoma	Thomas
Thomasb	Thomas
Thomasg	Thomas
Thoms	Thomas
Thos	Thomas
Tmothy	Timothy
Trebor	Trevor
Tresure	Treasure
Trever	Trevor
Ttacey	Tracey
Ttanter	Tanter
Ttarvers	Tarvers
Tteherne	Teherene
Ttempleton	Templeton
Tterence	Terence
Ttheodore	Theodore
Tthomas	Thomas
Tthomas	Thomas
Tthompson	Thompson
Tthomson	Thomsom
Tthrelfall	Threlfall
Tthurza	Thurza
Ttimothy	Timothy
Ttom	Tom
Ttorstein	Torstein
Ttowndrow	Towndrow
Ttracey	Tracey
Ttracy	Tracy
Ttrecey	Trecey
Ttrevor	Trevor
Ttristram	Tristram
Tturston	Turtston
Uunsworth	Unsworth
Uusman	Usman
Uuttley	Uttley
Veonica	Veronica
Verinoca	Veronica
Veromica	Veronica
Veronca	Veronica
Veronoca	Veronica
Verononica	Veronica
Vicotr	Victor
Vicotria	Victoria
Vicotria	Victoria
Vicror	Victor
Vicrtoria	Victoria
Victiria	Victoria
Victora	Victoria
Victoriaj	Victoria
Victorias	Victoria
Victorla	Victoria
Victorna	Victoria
Victoroa	Victoria
Victotria	Victoria
Victpr	Victor
Vicvoria	Victoria
Vicyor	Victor
Vidtoria	Victoria
Violer	Violet
Virigina	Virginia
Vivtor	Victor
Vivtoria	Victoria
Voilet	Violet
Vvalentine	Valentine
Vvienne	Vivienne
Vvincent	Vincent
Vvincenzo	Vincenzo
Vvonne	Yvonne
Wakter	Walter
Waltere	Walter
Waltr	Walter
Waqlter	Walter
Wifred	Wilfred
Wifrid	Wilfred
Wiiiam	William
Wiiliam	William
Wiilliam	William
Wiillie	Willie
Wiliiam	William
Willaim	William
Williamf	William
Williamg	William
Williamh	William
Williamr	William
Willian	William
Willilam	William
Willliam	William
Willm	William
Willuiam	William
Winefreed	Winifred
Winefret	Winifred
Winiferd	Winifred
Winifrad	Winifred
Winifread	Winifred
Winifrecl	Winifred
Winifredc	Winifred
Winifredd	Winifred
Winifredw	Winifred
Winifrred	Winifred
Winiftred	Winifred
Winisome	Winsome
Wjlliam	William
Wlater	Walter
Wliliam	William
Wlliam	William
Wllliam	William
Wllm	William
Wlm	William
Wm	William
Wndsor	Windsor
Wnedy	Wendy
Wooodhouse	Woodhouse
Wtnne	Wynne
Wwalker	Walker
Wwalklett	Walklett
Wwalter	Walter
Wwalter	Walter
Wwalton	Walton
Wwarburton	Warburton
Wwarwick	Warwick
Wwatson	Watson
Wwayne	Wayne
Wwei	Wei
Wwendy	Wendy
Wwhittaker	Whittaker
Wwhittaker Whittaker	
Wwilliam	William
Wwilliamson	Williamson
Wwillie	Willie
Wwilson	Wilson
Wwndy	Wendy
Wwolstencroft	Wolstencroft
Xxxx	
Xxxxxxxxx	
Ylusuf	Yusuf
Yvevette	Yvette
Yyonne	Yvonne
Yyoung	Young
Yypres	Ypres
Yypres	Ypres
Yyvonne	Yvonne
Zzzzz	